.....................
..........S...X......
.....X...XXX.X.......
.....X......X........
.....X....SX.........
.....X.S..XS.........
.....X....X..........
.....X...SX..........
.......XXXXS.........
.........XXXXXXXX....
.....X...X...........
.....X...XX..........
.....X...SX..........
.....X.........X.....
.....X.........X.....
.....XXXXXXXXXXX.S...
...............X.....
...S...........X.....
.....................
.....................
.....................